Cave World 2
035 013
                                   
 #########                         
 #.......#                   ###   
 #.......#             #######.#   
 #.......#             #.......#   
 #.......###############.########  
####.#####......................#  
#.............................#####
#.................................#
############.##############...###.#
        #.....#           #...# ###
        #.....#           #####    
        #######                    
H.Player.txt
005,004,defaultInv
H.Monster.txt
009,007,defaultInv
H.Monster.txt
010,011,defaultInv
C.Barrel.txt
008,003,defaultInv
C.Barrel.txt
011,006,defaultInv
C.Barrel.txt
002,008,defaultInv