Dungeon Run
128 014
     ###                                   ####    ###                   #######                   ###                          
     #.#                                   #..######.#########           #.....#          ##########.#                          
######.####              #############     #.................#           ####.##          #..........#   #############          
#.........################...........########..###########..############    #.#    ###########...#########...........#          
#......................................................................######.######.................................###########
#..............................................................................................................................#
#....................................................................................................................###########
#.........#######..##################.###########........................###########.#########...#####.#####.#########          
###########     #..#                #.#         ##########################         #.#       #...#   ###   #.#                  
                #..#        #########.#                                            #.#   #####...#         #.#                  
           ######..######   #.........#                             ################.#   #.......#         #.###########        
           #............#####.#########                          ####................#####.......#         #...........#        
           #..................#                                  #.....###########...............#         #############         
           ####################                                  #######         #################                              
H.Player.txt
003,005,defaultInv
H.Monster.txt
052,001,defaultInv
H.Snake.txt
095,011,defaultInv
C.Barrel.txt
055,007,defaultInv