Test World 2
061 026
                                                             
 ############################################################
 #''''''''''''''#'''''''''''''''''''''''#'''''''''TTTTTTTTTT#
 #'T'''''##'''''#'T'''''''''''''''''''''#''''''''''TTTTTTTTT#
 #'''''''#'''#''#'''''''##'#'###'''T''''#''''''''''''''TTTTT#
 #'''T'T''#''#'''''''''''''''''''''TT'''#''''''''''''''TTTTT#
 #''TTT'''''''''''''''''#''''''#''''''''''''''''''''''''TTTT#
 #'''TT'''---'''#''''''''''#'#'#''''''''''''''''''''''TTTTTT#
 #'''''''|_'_|'''''''T'''''''''''''''''''''''''''''''TTTTTTT#
 #''''''''''''''#'''''''''''''''''www'''#'''''''''''''''''TT#
 #'##'''''##'####''''''''''T''''''wwww''#'##''''''''''TTTTTT#
 #''''''''''''''''''''''''TT''#''wwwww''#'''''''''''TTTTTTT'#
 #''''T'''''''''''''''''''''''''''''ww''#''''''#''''TTTTTTT'#
 #'''''''''TT''''''''T''''''''###'#'''''#''''''#'''TTTTTTTTT#
 #''''''''''''''''''''''''''''''''''''''#''''''#'''''TTTTTTT#
 ######################'''###############'''###'''''''''''''#
 #''''''''''''''''''''''''''''''''''''''''''''''''''''''''''#
 #'''TTT''''''''''''''''''''TTTTTTT''#'''''''''#''''''''''''#
 #''TTT'''''##''#'''''''''TTTTTTTTTT'''''''''''''''''''T''''#
 #''TTTT''''''''#''''''''TTTTTTTTT'''''''''''''#'''''TTTT'''#
 #'''TTT'''''''''''''''''TTTTTTT'''##''#'###'#'''''''TTTT'''#
 #'''''''#''''''#'''''''TTTTTTTT'''''''''''''''''''''TTTT'''#
 #''''T'''''''''''''''''''TTTTTTTTT'''''''''''''''''TTTTT'''#
 #''''''''''''''''''''''''''TTTTT'''''''''''''''''''TTT'''''#
 #''''''''''''''''''''''''''TTTT''''''''''''''''''''''''''''#
 ############################################################
H.Player.txt
005,004,defaultInv
H.Monster.txt
008,007,defaultInv
C.Barrel.txt
008,003,defaultInv